AALEN - sich behaglich ausstrecken, sich rekeln
AALFANG - das Fangen des Aales
AALFISCHER - Fischer, der besonders auf Aalfang ausgeht
AALGLATT - überaus glatt
AALKASTEN - aus Lattenrosten bestehende Fangvorrichtung, in die das einströmende Wasser den Aal hineinzieht
AALKÄSTEN - aus Lattenrosten bestehende Fangvorrichtung, in die das einströmende Wasser den Aal hineinzieht
AALKORB - Fanggerät für Aale
AALMUTTER - (in kalten Meeren, teilweise in großen Tiefen lebender) Fisch, der lebende Junge zur Welt bringt
AALQUAPPE - (zu den Dorschfischen gehörender) im Süßwasser lebender, großer Raubfisch von graubrauner Färbung mit langer Afterflosse
AALRÄUCHEREI - das Räuchern von Aalen
AALRAUPE - Rutte
AALREUSE - korbartige Vorrichtung mit trichterförmigem Eingang zum Fangen von Aalen
AALSPEER - Spieß zum Aalstechen
AALSTECHEN - Stechen nach dem Aal mit dem Aalspeer
AALSTRICH - schmaler Rückenstreifen bei Pferden, Rindern, Hirschen
AALSUPPE - aus dem Fleisch vom Aal zubereitete Suppe
AALTIERCHEN - Älchen
AARGAU - Schweizer Kanton
AASBLUME - Blume mit nach Aas riechender Blüte, die Aasfliegen anzieht
AASFLIEGE - Fliege, die sich auf Schmutz und Unrat aufhält, Schmeißfliege
AASGEIER - vom Aas lebender Raubvogel
AASGERUCH - für verwesende Tierleichen charakteristischer Geruch
AASGESTANK - schlechter Geruch (wie) nach faulendem Aas
AASJÄGER - Jäger, der gegen die Regeln des Weidwerks verstößt
AASKÄFER - aasfressender Käfer
AASKRÄHE - Rabenvogel (Nebelkrähe und Rabenkrähe), der unter anderem Aas frisst
AASVOGEL - aasfressender Vogel
AASVÖGEL - aasfressender Vogel
ABAKUS - einfaches Rechengerät, meist in Form eines Gestells mit mehreren Reihen von Stangen oder Führungen, auf denen...
ABÄNDERN - etw. teilweise verändern, ein wenig umgestalten
ABÄNDERUNG - teilweise Veränderung, Umgestaltung
ABARBEITEN - sich abmühen, stark anstrengen
ABARBEITUNG - Erledigung durch Bearbeitung in einer bestimmten vorgegebenen Reihenfolge
ABART - ähnliche, in einigen Zügen etwas abweichende Art, Spielart
ABARTEN - von der üblichen Art abweichen, aus der Art schlagen
ABARTIG - von der Norm abweichend, aus der Art geschlagen
ABARTIGKEIT - Abnormität, Widernatürlichkeit
ABBA - Anrede Gottes im Neuen Testament
ABBAGGERN - mit dem Bagger beseitigen
ABBAGGERUNG - das Beseitigen von Material, besonders von Erdreich, mit einem Bagger
ABBAU - Förderung, Gewinnung von Bodenschätzen
ABBAUARBEIT - Arbeit des Abbaus
ABBAUBAR - sich biologisch abbauen lassend
ABBAUEN - Bodenschätze fördern, gewinnen
ABBAUFELD - Bereich, in dem Bodenschätze abgebaut werden
ABBAUGERÄT - Vorrichtung zur Förderung von Bodenschätzen
ABBAUHAMMER - Druckluftwerkzeug zum Losmeißeln von Kohle
ABBAUHÄMMER - Druckluftwerkzeug zum Losmeißeln von Kohle
ABBAULAND - landwirtschaftlich nicht genutztes Land
ABBAUMETHODE - Verfahren zur Förderung von Bodenschätzen
ABBAUORT - Ort des Abbaus
ABBAUPRODUKT - Stoff, der durch eine chemische Zerlegung oder Zersetzung entsteht
ABBAURECHT - Bevollmächtigung, Konzession zur Förderung von Bodenschätzen
ABBAUSOHLE - horizontaler Abschnitt beim Abbau
ABBAUSTOSS - seitliche Wand im Abbau
ABBAUSTRECKE - Zugang und Abgang vom Abbau
ABBAUVERLUST - bei der Gewinnung von Bodenschätzen nicht abbaubare und daher verlorengehende Lagerstättenanteile
ABBAUWÜRDIG - mit wirtschaftlichem Erfolg gewinnbar
ABBEDINGEN - durch Vertrag außer Kraft setzen
ABBEISSEN - etw. mit den Zähnen abtrennen
ABBEIZEN - etw. durch chemische Lösungsmittel entfernen
ABBEKOMMEN - etw. als Teil eines Ganzen, aus einer Menge erhalten
ABBERUFEN - jmdn. von seinem Posten zurückrufen
ABBERUFUNG - Entzug eines Amtes, einer Dienststellung
ABBESTELLEN - eine Bestellung widerrufen, rückgängig machen
ABBESTELLUNG - Zurückziehung einer Bestellung
ABBETTELN - etw. von jmdm. durch fortwährendes Bitten erlangen
ABBEZAHLEN - etw. in Raten bezahlen
ABBIEGEN - eine andere Richtung einschlagen
ABBIEGESPUR - mit Pfeilen nach links oder rechts markierte Spur einer Fahrbahn, die man als Fahrer eines Fahrzeugs...
ABBIEGUNG - Abzweigung
ABBILD - genaue Wiedergabe eines Bildes, Urbildes, Bild
ABBILDBAR - so, dass ein Abbild davon gemacht werden kann
ABBILDEN - etw., jmdn. bildlich darstellen